#.#############
#.##..#.#k.#..#
#.##.##.##...##
#.....#.#..####
###.###.#.###.#
###.##..#.....#
#....##...#####
####.####...#.#
#.#...##..#...#
#.##.##..######
#.#..#..##.##.#
#.##.#.###....#
#......#.#.##.#
#.#.##......#.#
#############.#
