#.#############
#.#........k###
#.#.#######.###
#.########..###
#..#....##.####
##.####.##.####
##.####.##.####
##.........####
####.##.#######
##...##....####
#######.#######
#######.#######
#####.........#
#############.#
#############.#
